"filename", "language", "HTML", "TypeScript", "SCSS", "comment", "blank", "total"
"/Users/gregd/Desktop/Gregs Workspace/Work/TravelSoft/ibus driver xristos/iBus-Driver-Application-v1/src/app/app-routing.module.ts", "TypeScript", 0, 132, 0, 0, 3, 135
"/Users/gregd/Desktop/Gregs Workspace/Work/TravelSoft/ibus driver xristos/iBus-Driver-Application-v1/src/app/app.component.html", "HTML", 3, 0, 0, 0, 1, 4
"/Users/gregd/Desktop/Gregs Workspace/Work/TravelSoft/ibus driver xristos/iBus-Driver-Application-v1/src/app/app.component.scss", "SCSS", 0, 0, 0, 0, 1, 1
"/Users/gregd/Desktop/Gregs Workspace/Work/TravelSoft/ibus driver xristos/iBus-Driver-Application-v1/src/app/app.component.spec.ts", "TypeScript", 0, 39, 0, 1, 11, 51
"/Users/gregd/Desktop/Gregs Workspace/Work/TravelSoft/ibus driver xristos/iBus-Driver-Application-v1/src/app/app.component.ts", "TypeScript", 0, 113, 0, 68, 36, 217
"/Users/gregd/Desktop/Gregs Workspace/Work/TravelSoft/ibus driver xristos/iBus-Driver-Application-v1/src/app/app.module.ts", "TypeScript", 0, 62, 0, 1, 8, 71
"/Users/gregd/Desktop/Gregs Workspace/Work/TravelSoft/ibus driver xristos/iBus-Driver-Application-v1/src/app/components/routelist-bottom-bar/routelist-bottom-bar.component.html", "HTML", 0, 0, 0, 0, 1, 1
"/Users/gregd/Desktop/Gregs Workspace/Work/TravelSoft/ibus driver xristos/iBus-Driver-Application-v1/src/app/components/routelist-bottom-bar/routelist-bottom-bar.component.scss", "SCSS", 0, 0, 0, 0, 1, 1
"/Users/gregd/Desktop/Gregs Workspace/Work/TravelSoft/ibus driver xristos/iBus-Driver-Application-v1/src/app/components/routelist-bottom-bar/routelist-bottom-bar.component.spec.ts", "TypeScript", 0, 19, 0, 0, 6, 25
"/Users/gregd/Desktop/Gregs Workspace/Work/TravelSoft/ibus driver xristos/iBus-Driver-Application-v1/src/app/components/routelist-bottom-bar/routelist-bottom-bar.component.ts", "TypeScript", 0, 10, 0, 0, 5, 15
"/Users/gregd/Desktop/Gregs Workspace/Work/TravelSoft/ibus driver xristos/iBus-Driver-Application-v1/src/app/createroute/createroute-routing.module.ts", "TypeScript", 0, 14, 0, 0, 4, 18
"/Users/gregd/Desktop/Gregs Workspace/Work/TravelSoft/ibus driver xristos/iBus-Driver-Application-v1/src/app/createroute/createroute.module.ts", "TypeScript", 0, 16, 0, 0, 5, 21
"/Users/gregd/Desktop/Gregs Workspace/Work/TravelSoft/ibus driver xristos/iBus-Driver-Application-v1/src/app/createroute/createroute.page.html", "HTML", 7, 0, 0, 0, 3, 10
"/Users/gregd/Desktop/Gregs Workspace/Work/TravelSoft/ibus driver xristos/iBus-Driver-Application-v1/src/app/createroute/createroute.page.scss", "SCSS", 0, 0, 0, 0, 1, 1
"/Users/gregd/Desktop/Gregs Workspace/Work/TravelSoft/ibus driver xristos/iBus-Driver-Application-v1/src/app/createroute/createroute.page.spec.ts", "TypeScript", 0, 19, 0, 0, 6, 25
"/Users/gregd/Desktop/Gregs Workspace/Work/TravelSoft/ibus driver xristos/iBus-Driver-Application-v1/src/app/createroute/createroute.page.ts", "TypeScript", 0, 11, 0, 0, 5, 16
"/Users/gregd/Desktop/Gregs Workspace/Work/TravelSoft/ibus driver xristos/iBus-Driver-Application-v1/src/app/forgotpass/forgotpass-routing.module.ts", "TypeScript", 0, 14, 0, 0, 4, 18
"/Users/gregd/Desktop/Gregs Workspace/Work/TravelSoft/ibus driver xristos/iBus-Driver-Application-v1/src/app/forgotpass/forgotpass.module.ts", "TypeScript", 0, 18, 0, 0, 5, 23
"/Users/gregd/Desktop/Gregs Workspace/Work/TravelSoft/ibus driver xristos/iBus-Driver-Application-v1/src/app/forgotpass/forgotpass.page.html", "HTML", 32, 0, 0, 2, 5, 39
"/Users/gregd/Desktop/Gregs Workspace/Work/TravelSoft/ibus driver xristos/iBus-Driver-Application-v1/src/app/forgotpass/forgotpass.page.scss", "SCSS", 0, 0, 121, 0, 5, 126
"/Users/gregd/Desktop/Gregs Workspace/Work/TravelSoft/ibus driver xristos/iBus-Driver-Application-v1/src/app/forgotpass/forgotpass.page.spec.ts", "TypeScript", 0, 19, 0, 0, 6, 25
"/Users/gregd/Desktop/Gregs Workspace/Work/TravelSoft/ibus driver xristos/iBus-Driver-Application-v1/src/app/forgotpass/forgotpass.page.ts", "TypeScript", 0, 15, 0, 0, 5, 20
"/Users/gregd/Desktop/Gregs Workspace/Work/TravelSoft/ibus driver xristos/iBus-Driver-Application-v1/src/app/home/home-routing.module.ts", "TypeScript", 0, 14, 0, 0, 3, 17
"/Users/gregd/Desktop/Gregs Workspace/Work/TravelSoft/ibus driver xristos/iBus-Driver-Application-v1/src/app/home/home.module.ts", "TypeScript", 0, 17, 0, 0, 4, 21
"/Users/gregd/Desktop/Gregs Workspace/Work/TravelSoft/ibus driver xristos/iBus-Driver-Application-v1/src/app/home/home.page.html", "HTML", 27, 0, 0, 13, 3, 43
"/Users/gregd/Desktop/Gregs Workspace/Work/TravelSoft/ibus driver xristos/iBus-Driver-Application-v1/src/app/home/home.page.scss", "SCSS", 0, 0, 93, 1, 11, 105
"/Users/gregd/Desktop/Gregs Workspace/Work/TravelSoft/ibus driver xristos/iBus-Driver-Application-v1/src/app/home/home.page.spec.ts", "TypeScript", 0, 19, 0, 0, 6, 25
"/Users/gregd/Desktop/Gregs Workspace/Work/TravelSoft/ibus driver xristos/iBus-Driver-Application-v1/src/app/home/home.page.ts", "TypeScript", 0, 32, 0, 11, 8, 51
"/Users/gregd/Desktop/Gregs Workspace/Work/TravelSoft/ibus driver xristos/iBus-Driver-Application-v1/src/app/home2/home2-routing.module.ts", "TypeScript", 0, 36, 0, 0, 7, 43
"/Users/gregd/Desktop/Gregs Workspace/Work/TravelSoft/ibus driver xristos/iBus-Driver-Application-v1/src/app/home2/home2.module.ts", "TypeScript", 0, 16, 0, 0, 5, 21
"/Users/gregd/Desktop/Gregs Workspace/Work/TravelSoft/ibus driver xristos/iBus-Driver-Application-v1/src/app/home2/home2.page.html", "HTML", 0, 0, 0, 7, 2, 9
"/Users/gregd/Desktop/Gregs Workspace/Work/TravelSoft/ibus driver xristos/iBus-Driver-Application-v1/src/app/home2/home2.page.scss", "SCSS", 0, 0, 46, 0, 1, 47
"/Users/gregd/Desktop/Gregs Workspace/Work/TravelSoft/ibus driver xristos/iBus-Driver-Application-v1/src/app/home2/home2.page.spec.ts", "TypeScript", 0, 19, 0, 0, 6, 25
"/Users/gregd/Desktop/Gregs Workspace/Work/TravelSoft/ibus driver xristos/iBus-Driver-Application-v1/src/app/home2/home2.page.ts", "TypeScript", 0, 36, 0, 0, 6, 42
"/Users/gregd/Desktop/Gregs Workspace/Work/TravelSoft/ibus driver xristos/iBus-Driver-Application-v1/src/app/language/language-routing.module.ts", "TypeScript", 0, 14, 0, 0, 4, 18
"/Users/gregd/Desktop/Gregs Workspace/Work/TravelSoft/ibus driver xristos/iBus-Driver-Application-v1/src/app/language/language.module.ts", "TypeScript", 0, 16, 0, 0, 5, 21
"/Users/gregd/Desktop/Gregs Workspace/Work/TravelSoft/ibus driver xristos/iBus-Driver-Application-v1/src/app/language/language.page.html", "HTML", 11, 0, 0, 0, 0, 11
"/Users/gregd/Desktop/Gregs Workspace/Work/TravelSoft/ibus driver xristos/iBus-Driver-Application-v1/src/app/language/language.page.scss", "SCSS", 0, 0, 42, 0, 2, 44
"/Users/gregd/Desktop/Gregs Workspace/Work/TravelSoft/ibus driver xristos/iBus-Driver-Application-v1/src/app/language/language.page.spec.ts", "TypeScript", 0, 19, 0, 0, 6, 25
"/Users/gregd/Desktop/Gregs Workspace/Work/TravelSoft/ibus driver xristos/iBus-Driver-Application-v1/src/app/language/language.page.ts", "TypeScript", 0, 26, 0, 0, 5, 31
"/Users/gregd/Desktop/Gregs Workspace/Work/TravelSoft/ibus driver xristos/iBus-Driver-Application-v1/src/app/login/login-routing.module.ts", "TypeScript", 0, 14, 0, 0, 4, 18
"/Users/gregd/Desktop/Gregs Workspace/Work/TravelSoft/ibus driver xristos/iBus-Driver-Application-v1/src/app/login/login.module.ts", "TypeScript", 0, 20, 0, 0, 6, 26
"/Users/gregd/Desktop/Gregs Workspace/Work/TravelSoft/ibus driver xristos/iBus-Driver-Application-v1/src/app/login/login.page.html", "HTML", 37, 0, 0, 5, 9, 51
"/Users/gregd/Desktop/Gregs Workspace/Work/TravelSoft/ibus driver xristos/iBus-Driver-Application-v1/src/app/login/login.page.scss", "SCSS", 0, 0, 96, 0, 3, 99
"/Users/gregd/Desktop/Gregs Workspace/Work/TravelSoft/ibus driver xristos/iBus-Driver-Application-v1/src/app/login/login.page.spec.ts", "TypeScript", 0, 19, 0, 0, 6, 25
"/Users/gregd/Desktop/Gregs Workspace/Work/TravelSoft/ibus driver xristos/iBus-Driver-Application-v1/src/app/login/login.page.ts", "TypeScript", 0, 230, 0, 2, 52, 284
"/Users/gregd/Desktop/Gregs Workspace/Work/TravelSoft/ibus driver xristos/iBus-Driver-Application-v1/src/app/maintenance/maintenance-routing.module.ts", "TypeScript", 0, 14, 0, 0, 4, 18
"/Users/gregd/Desktop/Gregs Workspace/Work/TravelSoft/ibus driver xristos/iBus-Driver-Application-v1/src/app/maintenance/maintenance.module.ts", "TypeScript", 0, 18, 0, 0, 5, 23
"/Users/gregd/Desktop/Gregs Workspace/Work/TravelSoft/ibus driver xristos/iBus-Driver-Application-v1/src/app/maintenance/maintenance.page.html", "HTML", 102, 0, 0, 0, 12, 114
"/Users/gregd/Desktop/Gregs Workspace/Work/TravelSoft/ibus driver xristos/iBus-Driver-Application-v1/src/app/maintenance/maintenance.page.scss", "SCSS", 0, 0, 248, 0, 8, 256
"/Users/gregd/Desktop/Gregs Workspace/Work/TravelSoft/ibus driver xristos/iBus-Driver-Application-v1/src/app/maintenance/maintenance.page.spec.ts", "TypeScript", 0, 19, 0, 0, 6, 25
"/Users/gregd/Desktop/Gregs Workspace/Work/TravelSoft/ibus driver xristos/iBus-Driver-Application-v1/src/app/maintenance/maintenance.page.ts", "TypeScript", 0, 37, 0, 5, 3, 45
"/Users/gregd/Desktop/Gregs Workspace/Work/TravelSoft/ibus driver xristos/iBus-Driver-Application-v1/src/app/map/map-routing.module.ts", "TypeScript", 0, 14, 0, 0, 4, 18
"/Users/gregd/Desktop/Gregs Workspace/Work/TravelSoft/ibus driver xristos/iBus-Driver-Application-v1/src/app/map/map.module.ts", "TypeScript", 0, 18, 0, 0, 5, 23
"/Users/gregd/Desktop/Gregs Workspace/Work/TravelSoft/ibus driver xristos/iBus-Driver-Application-v1/src/app/map/map.page.html", "HTML", 30, 0, 0, 44, 11, 85
"/Users/gregd/Desktop/Gregs Workspace/Work/TravelSoft/ibus driver xristos/iBus-Driver-Application-v1/src/app/map/map.page.scss", "SCSS", 0, 0, 119, 8, 6, 133
"/Users/gregd/Desktop/Gregs Workspace/Work/TravelSoft/ibus driver xristos/iBus-Driver-Application-v1/src/app/map/map.page.spec.ts", "TypeScript", 0, 19, 0, 0, 6, 25
"/Users/gregd/Desktop/Gregs Workspace/Work/TravelSoft/ibus driver xristos/iBus-Driver-Application-v1/src/app/map/map.page.ts", "TypeScript", 0, 367, 0, 16, 47, 430
"/Users/gregd/Desktop/Gregs Workspace/Work/TravelSoft/ibus driver xristos/iBus-Driver-Application-v1/src/app/notifications/notifications-routing.module.ts", "TypeScript", 0, 14, 0, 0, 4, 18
"/Users/gregd/Desktop/Gregs Workspace/Work/TravelSoft/ibus driver xristos/iBus-Driver-Application-v1/src/app/notifications/notifications.module.ts", "TypeScript", 0, 16, 0, 0, 5, 21
"/Users/gregd/Desktop/Gregs Workspace/Work/TravelSoft/ibus driver xristos/iBus-Driver-Application-v1/src/app/notifications/notifications.page.html", "HTML", 7, 0, 0, 0, 3, 10
"/Users/gregd/Desktop/Gregs Workspace/Work/TravelSoft/ibus driver xristos/iBus-Driver-Application-v1/src/app/notifications/notifications.page.scss", "SCSS", 0, 0, 0, 0, 1, 1
"/Users/gregd/Desktop/Gregs Workspace/Work/TravelSoft/ibus driver xristos/iBus-Driver-Application-v1/src/app/notifications/notifications.page.spec.ts", "TypeScript", 0, 19, 0, 0, 6, 25
"/Users/gregd/Desktop/Gregs Workspace/Work/TravelSoft/ibus driver xristos/iBus-Driver-Application-v1/src/app/notifications/notifications.page.ts", "TypeScript", 0, 11, 0, 0, 5, 16
"/Users/gregd/Desktop/Gregs Workspace/Work/TravelSoft/ibus driver xristos/iBus-Driver-Application-v1/src/app/passrec/passrec-routing.module.ts", "TypeScript", 0, 14, 0, 0, 4, 18
"/Users/gregd/Desktop/Gregs Workspace/Work/TravelSoft/ibus driver xristos/iBus-Driver-Application-v1/src/app/passrec/passrec.module.ts", "TypeScript", 0, 18, 0, 0, 5, 23
"/Users/gregd/Desktop/Gregs Workspace/Work/TravelSoft/ibus driver xristos/iBus-Driver-Application-v1/src/app/passrec/passrec.page.html", "HTML", 24, 0, 0, 0, 6, 30
"/Users/gregd/Desktop/Gregs Workspace/Work/TravelSoft/ibus driver xristos/iBus-Driver-Application-v1/src/app/passrec/passrec.page.scss", "SCSS", 0, 0, 99, 0, 3, 102
"/Users/gregd/Desktop/Gregs Workspace/Work/TravelSoft/ibus driver xristos/iBus-Driver-Application-v1/src/app/passrec/passrec.page.spec.ts", "TypeScript", 0, 19, 0, 0, 6, 25
"/Users/gregd/Desktop/Gregs Workspace/Work/TravelSoft/ibus driver xristos/iBus-Driver-Application-v1/src/app/passrec/passrec.page.ts", "TypeScript", 0, 11, 0, 0, 5, 16
"/Users/gregd/Desktop/Gregs Workspace/Work/TravelSoft/ibus driver xristos/iBus-Driver-Application-v1/src/app/privacy/privacy-routing.module.ts", "TypeScript", 0, 14, 0, 0, 4, 18
"/Users/gregd/Desktop/Gregs Workspace/Work/TravelSoft/ibus driver xristos/iBus-Driver-Application-v1/src/app/privacy/privacy.module.ts", "TypeScript", 0, 16, 0, 0, 5, 21
"/Users/gregd/Desktop/Gregs Workspace/Work/TravelSoft/ibus driver xristos/iBus-Driver-Application-v1/src/app/privacy/privacy.page.html", "HTML", 7, 0, 0, 0, 3, 10
"/Users/gregd/Desktop/Gregs Workspace/Work/TravelSoft/ibus driver xristos/iBus-Driver-Application-v1/src/app/privacy/privacy.page.scss", "SCSS", 0, 0, 0, 0, 1, 1
"/Users/gregd/Desktop/Gregs Workspace/Work/TravelSoft/ibus driver xristos/iBus-Driver-Application-v1/src/app/privacy/privacy.page.spec.ts", "TypeScript", 0, 19, 0, 0, 6, 25
"/Users/gregd/Desktop/Gregs Workspace/Work/TravelSoft/ibus driver xristos/iBus-Driver-Application-v1/src/app/privacy/privacy.page.ts", "TypeScript", 0, 11, 0, 0, 5, 16
"/Users/gregd/Desktop/Gregs Workspace/Work/TravelSoft/ibus driver xristos/iBus-Driver-Application-v1/src/app/profile/profile-routing.module.ts", "TypeScript", 0, 14, 0, 0, 4, 18
"/Users/gregd/Desktop/Gregs Workspace/Work/TravelSoft/ibus driver xristos/iBus-Driver-Application-v1/src/app/profile/profile.module.ts", "TypeScript", 0, 20, 0, 0, 5, 25
"/Users/gregd/Desktop/Gregs Workspace/Work/TravelSoft/ibus driver xristos/iBus-Driver-Application-v1/src/app/profile/profile.page.html", "HTML", 101, 0, 0, 4, 12, 117
"/Users/gregd/Desktop/Gregs Workspace/Work/TravelSoft/ibus driver xristos/iBus-Driver-Application-v1/src/app/profile/profile.page.scss", "SCSS", 0, 0, 168, 2, 9, 179
"/Users/gregd/Desktop/Gregs Workspace/Work/TravelSoft/ibus driver xristos/iBus-Driver-Application-v1/src/app/profile/profile.page.spec.ts", "TypeScript", 0, 19, 0, 0, 6, 25
"/Users/gregd/Desktop/Gregs Workspace/Work/TravelSoft/ibus driver xristos/iBus-Driver-Application-v1/src/app/profile/profile.page.ts", "TypeScript", 0, 78, 0, 3, 13, 94
"/Users/gregd/Desktop/Gregs Workspace/Work/TravelSoft/ibus driver xristos/iBus-Driver-Application-v1/src/app/register/register-routing.module.ts", "TypeScript", 0, 14, 0, 0, 4, 18
"/Users/gregd/Desktop/Gregs Workspace/Work/TravelSoft/ibus driver xristos/iBus-Driver-Application-v1/src/app/register/register.module.ts", "TypeScript", 0, 20, 0, 0, 5, 25
"/Users/gregd/Desktop/Gregs Workspace/Work/TravelSoft/ibus driver xristos/iBus-Driver-Application-v1/src/app/register/register.page.html", "HTML", 84, 0, 0, 1, 7, 92
"/Users/gregd/Desktop/Gregs Workspace/Work/TravelSoft/ibus driver xristos/iBus-Driver-Application-v1/src/app/register/register.page.scss", "SCSS", 0, 0, 132, 6, 12, 150
"/Users/gregd/Desktop/Gregs Workspace/Work/TravelSoft/ibus driver xristos/iBus-Driver-Application-v1/src/app/register/register.page.spec.ts", "TypeScript", 0, 19, 0, 0, 6, 25
"/Users/gregd/Desktop/Gregs Workspace/Work/TravelSoft/ibus driver xristos/iBus-Driver-Application-v1/src/app/register/register.page.ts", "TypeScript", 0, 106, 0, 1, 16, 123
"/Users/gregd/Desktop/Gregs Workspace/Work/TravelSoft/ibus driver xristos/iBus-Driver-Application-v1/src/app/register2/register2-routing.module.ts", "TypeScript", 0, 14, 0, 0, 4, 18
"/Users/gregd/Desktop/Gregs Workspace/Work/TravelSoft/ibus driver xristos/iBus-Driver-Application-v1/src/app/register2/register2.module.ts", "TypeScript", 0, 20, 0, 0, 5, 25
"/Users/gregd/Desktop/Gregs Workspace/Work/TravelSoft/ibus driver xristos/iBus-Driver-Application-v1/src/app/register2/register2.page.html", "HTML", 62, 0, 0, 1, 6, 69
"/Users/gregd/Desktop/Gregs Workspace/Work/TravelSoft/ibus driver xristos/iBus-Driver-Application-v1/src/app/register2/register2.page.scss", "SCSS", 0, 0, 132, 4, 10, 146
"/Users/gregd/Desktop/Gregs Workspace/Work/TravelSoft/ibus driver xristos/iBus-Driver-Application-v1/src/app/register2/register2.page.spec.ts", "TypeScript", 0, 19, 0, 0, 6, 25
"/Users/gregd/Desktop/Gregs Workspace/Work/TravelSoft/ibus driver xristos/iBus-Driver-Application-v1/src/app/register2/register2.page.ts", "TypeScript", 0, 85, 0, 5, 17, 107
"/Users/gregd/Desktop/Gregs Workspace/Work/TravelSoft/ibus driver xristos/iBus-Driver-Application-v1/src/app/register3/register3-routing.module.ts", "TypeScript", 0, 14, 0, 0, 4, 18
"/Users/gregd/Desktop/Gregs Workspace/Work/TravelSoft/ibus driver xristos/iBus-Driver-Application-v1/src/app/register3/register3.module.ts", "TypeScript", 0, 20, 0, 0, 5, 25
"/Users/gregd/Desktop/Gregs Workspace/Work/TravelSoft/ibus driver xristos/iBus-Driver-Application-v1/src/app/register3/register3.page.html", "HTML", 49, 0, 0, 10, 4, 63
"/Users/gregd/Desktop/Gregs Workspace/Work/TravelSoft/ibus driver xristos/iBus-Driver-Application-v1/src/app/register3/register3.page.scss", "SCSS", 0, 0, 177, 11, 11, 199
"/Users/gregd/Desktop/Gregs Workspace/Work/TravelSoft/ibus driver xristos/iBus-Driver-Application-v1/src/app/register3/register3.page.spec.ts", "TypeScript", 0, 19, 0, 0, 6, 25
"/Users/gregd/Desktop/Gregs Workspace/Work/TravelSoft/ibus driver xristos/iBus-Driver-Application-v1/src/app/register3/register3.page.ts", "TypeScript", 0, 234, 0, 12, 69, 315
"/Users/gregd/Desktop/Gregs Workspace/Work/TravelSoft/ibus driver xristos/iBus-Driver-Application-v1/src/app/registercomplete/registercomplete-routing.module.ts", "TypeScript", 0, 14, 0, 0, 4, 18
"/Users/gregd/Desktop/Gregs Workspace/Work/TravelSoft/ibus driver xristos/iBus-Driver-Application-v1/src/app/registercomplete/registercomplete.module.ts", "TypeScript", 0, 18, 0, 0, 5, 23
"/Users/gregd/Desktop/Gregs Workspace/Work/TravelSoft/ibus driver xristos/iBus-Driver-Application-v1/src/app/registercomplete/registercomplete.page.html", "HTML", 31, 0, 0, 0, 4, 35
"/Users/gregd/Desktop/Gregs Workspace/Work/TravelSoft/ibus driver xristos/iBus-Driver-Application-v1/src/app/registercomplete/registercomplete.page.scss", "SCSS", 0, 0, 137, 6, 5, 148
"/Users/gregd/Desktop/Gregs Workspace/Work/TravelSoft/ibus driver xristos/iBus-Driver-Application-v1/src/app/registercomplete/registercomplete.page.spec.ts", "TypeScript", 0, 19, 0, 0, 6, 25
"/Users/gregd/Desktop/Gregs Workspace/Work/TravelSoft/ibus driver xristos/iBus-Driver-Application-v1/src/app/registercomplete/registercomplete.page.ts", "TypeScript", 0, 18, 0, 0, 7, 25
"/Users/gregd/Desktop/Gregs Workspace/Work/TravelSoft/ibus driver xristos/iBus-Driver-Application-v1/src/app/routedetails/routedetails-routing.module.ts", "TypeScript", 0, 14, 0, 0, 4, 18
"/Users/gregd/Desktop/Gregs Workspace/Work/TravelSoft/ibus driver xristos/iBus-Driver-Application-v1/src/app/routedetails/routedetails.module.ts", "TypeScript", 0, 18, 0, 0, 5, 23
"/Users/gregd/Desktop/Gregs Workspace/Work/TravelSoft/ibus driver xristos/iBus-Driver-Application-v1/src/app/routedetails/routedetails.page.html", "HTML", 19, 0, 0, 0, 5, 24
"/Users/gregd/Desktop/Gregs Workspace/Work/TravelSoft/ibus driver xristos/iBus-Driver-Application-v1/src/app/routedetails/routedetails.page.scss", "SCSS", 0, 0, 109, 0, 5, 114
"/Users/gregd/Desktop/Gregs Workspace/Work/TravelSoft/ibus driver xristos/iBus-Driver-Application-v1/src/app/routedetails/routedetails.page.spec.ts", "TypeScript", 0, 19, 0, 0, 6, 25
"/Users/gregd/Desktop/Gregs Workspace/Work/TravelSoft/ibus driver xristos/iBus-Driver-Application-v1/src/app/routedetails/routedetails.page.ts", "TypeScript", 0, 52, 0, 4, 15, 71
"/Users/gregd/Desktop/Gregs Workspace/Work/TravelSoft/ibus driver xristos/iBus-Driver-Application-v1/src/app/routehistory/routehistory-routing.module.ts", "TypeScript", 0, 14, 0, 0, 4, 18
"/Users/gregd/Desktop/Gregs Workspace/Work/TravelSoft/ibus driver xristos/iBus-Driver-Application-v1/src/app/routehistory/routehistory.module.ts", "TypeScript", 0, 20, 0, 0, 5, 25
"/Users/gregd/Desktop/Gregs Workspace/Work/TravelSoft/ibus driver xristos/iBus-Driver-Application-v1/src/app/routehistory/routehistory.page.html", "HTML", 87, 0, 0, 0, 18, 105
"/Users/gregd/Desktop/Gregs Workspace/Work/TravelSoft/ibus driver xristos/iBus-Driver-Application-v1/src/app/routehistory/routehistory.page.scss", "SCSS", 0, 0, 388, 20, 13, 421
"/Users/gregd/Desktop/Gregs Workspace/Work/TravelSoft/ibus driver xristos/iBus-Driver-Application-v1/src/app/routehistory/routehistory.page.spec.ts", "TypeScript", 0, 19, 0, 0, 6, 25
"/Users/gregd/Desktop/Gregs Workspace/Work/TravelSoft/ibus driver xristos/iBus-Driver-Application-v1/src/app/routehistory/routehistory.page.ts", "TypeScript", 0, 290, 0, 23, 82, 395
"/Users/gregd/Desktop/Gregs Workspace/Work/TravelSoft/ibus driver xristos/iBus-Driver-Application-v1/src/app/routelist/routelist-routing.module.ts", "TypeScript", 0, 14, 0, 0, 4, 18
"/Users/gregd/Desktop/Gregs Workspace/Work/TravelSoft/ibus driver xristos/iBus-Driver-Application-v1/src/app/routelist/routelist.module.ts", "TypeScript", 0, 23, 0, 0, 7, 30
"/Users/gregd/Desktop/Gregs Workspace/Work/TravelSoft/ibus driver xristos/iBus-Driver-Application-v1/src/app/routelist/routelist.page.html", "HTML", 87, 0, 0, 0, 18, 105
"/Users/gregd/Desktop/Gregs Workspace/Work/TravelSoft/ibus driver xristos/iBus-Driver-Application-v1/src/app/routelist/routelist.page.scss", "SCSS", 0, 0, 388, 20, 13, 421
"/Users/gregd/Desktop/Gregs Workspace/Work/TravelSoft/ibus driver xristos/iBus-Driver-Application-v1/src/app/routelist/routelist.page.spec.ts", "TypeScript", 0, 19, 0, 0, 6, 25
"/Users/gregd/Desktop/Gregs Workspace/Work/TravelSoft/ibus driver xristos/iBus-Driver-Application-v1/src/app/routelist/routelist.page.ts", "TypeScript", 0, 293, 0, 23, 81, 397
"/Users/gregd/Desktop/Gregs Workspace/Work/TravelSoft/ibus driver xristos/iBus-Driver-Application-v1/src/app/routepassengers/routepassengers-routing.module.ts", "TypeScript", 0, 14, 0, 0, 4, 18
"/Users/gregd/Desktop/Gregs Workspace/Work/TravelSoft/ibus driver xristos/iBus-Driver-Application-v1/src/app/routepassengers/routepassengers.module.ts", "TypeScript", 0, 18, 0, 0, 5, 23
"/Users/gregd/Desktop/Gregs Workspace/Work/TravelSoft/ibus driver xristos/iBus-Driver-Application-v1/src/app/routepassengers/routepassengers.page.html", "HTML", 98, 0, 0, 36, 20, 154
"/Users/gregd/Desktop/Gregs Workspace/Work/TravelSoft/ibus driver xristos/iBus-Driver-Application-v1/src/app/routepassengers/routepassengers.page.scss", "SCSS", 0, 0, 256, 0, 10, 266
"/Users/gregd/Desktop/Gregs Workspace/Work/TravelSoft/ibus driver xristos/iBus-Driver-Application-v1/src/app/routepassengers/routepassengers.page.spec.ts", "TypeScript", 0, 19, 0, 0, 6, 25
"/Users/gregd/Desktop/Gregs Workspace/Work/TravelSoft/ibus driver xristos/iBus-Driver-Application-v1/src/app/routepassengers/routepassengers.page.ts", "TypeScript", 0, 151, 0, 1, 14, 166
"/Users/gregd/Desktop/Gregs Workspace/Work/TravelSoft/ibus driver xristos/iBus-Driver-Application-v1/src/app/routestarted/routestarted-routing.module.ts", "TypeScript", 0, 14, 0, 0, 4, 18
"/Users/gregd/Desktop/Gregs Workspace/Work/TravelSoft/ibus driver xristos/iBus-Driver-Application-v1/src/app/routestarted/routestarted.module.ts", "TypeScript", 0, 18, 0, 0, 5, 23
"/Users/gregd/Desktop/Gregs Workspace/Work/TravelSoft/ibus driver xristos/iBus-Driver-Application-v1/src/app/routestarted/routestarted.page.html", "HTML", 102, 0, 0, 123, 15, 240
"/Users/gregd/Desktop/Gregs Workspace/Work/TravelSoft/ibus driver xristos/iBus-Driver-Application-v1/src/app/routestarted/routestarted.page.scss", "SCSS", 0, 0, 277, 3, 10, 290
"/Users/gregd/Desktop/Gregs Workspace/Work/TravelSoft/ibus driver xristos/iBus-Driver-Application-v1/src/app/routestarted/routestarted.page.spec.ts", "TypeScript", 0, 19, 0, 0, 6, 25
"/Users/gregd/Desktop/Gregs Workspace/Work/TravelSoft/ibus driver xristos/iBus-Driver-Application-v1/src/app/routestarted/routestarted.page.ts", "TypeScript", 0, 152, 0, 1, 13, 166
"/Users/gregd/Desktop/Gregs Workspace/Work/TravelSoft/ibus driver xristos/iBus-Driver-Application-v1/src/app/services/data-resolver.service.spec.ts", "TypeScript", 0, 12, 0, 0, 5, 17
"/Users/gregd/Desktop/Gregs Workspace/Work/TravelSoft/ibus driver xristos/iBus-Driver-Application-v1/src/app/services/data-resolver.service.ts", "TypeScript", 0, 13, 0, 0, 5, 18
"/Users/gregd/Desktop/Gregs Workspace/Work/TravelSoft/ibus driver xristos/iBus-Driver-Application-v1/src/app/services/data.service.spec.ts", "TypeScript", 0, 12, 0, 0, 5, 17
"/Users/gregd/Desktop/Gregs Workspace/Work/TravelSoft/ibus driver xristos/iBus-Driver-Application-v1/src/app/services/data.service.ts", "TypeScript", 0, 14, 0, 0, 10, 24
"/Users/gregd/Desktop/Gregs Workspace/Work/TravelSoft/ibus driver xristos/iBus-Driver-Application-v1/src/app/services/language.service.spec.ts", "TypeScript", 0, 12, 0, 0, 5, 17
"/Users/gregd/Desktop/Gregs Workspace/Work/TravelSoft/ibus driver xristos/iBus-Driver-Application-v1/src/app/services/language.service.ts", "TypeScript", 0, 35, 0, 0, 5, 40
"/Users/gregd/Desktop/Gregs Workspace/Work/TravelSoft/ibus driver xristos/iBus-Driver-Application-v1/src/app/settings/settings-routing.module.ts", "TypeScript", 0, 14, 0, 0, 4, 18
"/Users/gregd/Desktop/Gregs Workspace/Work/TravelSoft/ibus driver xristos/iBus-Driver-Application-v1/src/app/settings/settings.module.ts", "TypeScript", 0, 18, 0, 0, 5, 23
"/Users/gregd/Desktop/Gregs Workspace/Work/TravelSoft/ibus driver xristos/iBus-Driver-Application-v1/src/app/settings/settings.page.html", "HTML", 107, 0, 0, 0, 15, 122
"/Users/gregd/Desktop/Gregs Workspace/Work/TravelSoft/ibus driver xristos/iBus-Driver-Application-v1/src/app/settings/settings.page.scss", "SCSS", 0, 0, 223, 36, 7, 266
"/Users/gregd/Desktop/Gregs Workspace/Work/TravelSoft/ibus driver xristos/iBus-Driver-Application-v1/src/app/settings/settings.page.spec.ts", "TypeScript", 0, 19, 0, 0, 6, 25
"/Users/gregd/Desktop/Gregs Workspace/Work/TravelSoft/ibus driver xristos/iBus-Driver-Application-v1/src/app/settings/settings.page.ts", "TypeScript", 0, 50, 0, 0, 4, 54
"/Users/gregd/Desktop/Gregs Workspace/Work/TravelSoft/ibus driver xristos/iBus-Driver-Application-v1/src/app/techhistory/techhistory-routing.module.ts", "TypeScript", 0, 14, 0, 0, 4, 18
"/Users/gregd/Desktop/Gregs Workspace/Work/TravelSoft/ibus driver xristos/iBus-Driver-Application-v1/src/app/techhistory/techhistory.module.ts", "TypeScript", 0, 16, 0, 0, 5, 21
"/Users/gregd/Desktop/Gregs Workspace/Work/TravelSoft/ibus driver xristos/iBus-Driver-Application-v1/src/app/techhistory/techhistory.page.html", "HTML", 8, 0, 0, 0, 4, 12
"/Users/gregd/Desktop/Gregs Workspace/Work/TravelSoft/ibus driver xristos/iBus-Driver-Application-v1/src/app/techhistory/techhistory.page.scss", "SCSS", 0, 0, 0, 0, 1, 1
"/Users/gregd/Desktop/Gregs Workspace/Work/TravelSoft/ibus driver xristos/iBus-Driver-Application-v1/src/app/techhistory/techhistory.page.spec.ts", "TypeScript", 0, 19, 0, 0, 6, 25
"/Users/gregd/Desktop/Gregs Workspace/Work/TravelSoft/ibus driver xristos/iBus-Driver-Application-v1/src/app/techhistory/techhistory.page.ts", "TypeScript", 0, 15, 0, 0, 5, 20
"/Users/gregd/Desktop/Gregs Workspace/Work/TravelSoft/ibus driver xristos/iBus-Driver-Application-v1/src/app/techinspect-finished-route/techinspect-finished-route-routing.module.ts", "TypeScript", 0, 14, 0, 0, 4, 18
"/Users/gregd/Desktop/Gregs Workspace/Work/TravelSoft/ibus driver xristos/iBus-Driver-Application-v1/src/app/techinspect-finished-route/techinspect-finished-route.module.ts", "TypeScript", 0, 20, 0, 0, 5, 25
"/Users/gregd/Desktop/Gregs Workspace/Work/TravelSoft/ibus driver xristos/iBus-Driver-Application-v1/src/app/techinspect-finished-route/techinspect-finished-route.page.html", "HTML", 112, 0, 0, 119, 35, 266
"/Users/gregd/Desktop/Gregs Workspace/Work/TravelSoft/ibus driver xristos/iBus-Driver-Application-v1/src/app/techinspect-finished-route/techinspect-finished-route.page.scss", "SCSS", 0, 0, 397, 42, 11, 450
"/Users/gregd/Desktop/Gregs Workspace/Work/TravelSoft/ibus driver xristos/iBus-Driver-Application-v1/src/app/techinspect-finished-route/techinspect-finished-route.page.spec.ts", "TypeScript", 0, 19, 0, 0, 6, 25
"/Users/gregd/Desktop/Gregs Workspace/Work/TravelSoft/ibus driver xristos/iBus-Driver-Application-v1/src/app/techinspect-finished-route/techinspect-finished-route.page.ts", "TypeScript", 0, 181, 0, 35, 35, 251
"/Users/gregd/Desktop/Gregs Workspace/Work/TravelSoft/ibus driver xristos/iBus-Driver-Application-v1/src/app/techinspect/techinspect-routing.module.ts", "TypeScript", 0, 14, 0, 0, 4, 18
"/Users/gregd/Desktop/Gregs Workspace/Work/TravelSoft/ibus driver xristos/iBus-Driver-Application-v1/src/app/techinspect/techinspect.module.ts", "TypeScript", 0, 20, 0, 0, 5, 25
"/Users/gregd/Desktop/Gregs Workspace/Work/TravelSoft/ibus driver xristos/iBus-Driver-Application-v1/src/app/techinspect/techinspect.page.html", "HTML", 112, 0, 0, 119, 35, 266
"/Users/gregd/Desktop/Gregs Workspace/Work/TravelSoft/ibus driver xristos/iBus-Driver-Application-v1/src/app/techinspect/techinspect.page.scss", "SCSS", 0, 0, 415, 42, 11, 468
"/Users/gregd/Desktop/Gregs Workspace/Work/TravelSoft/ibus driver xristos/iBus-Driver-Application-v1/src/app/techinspect/techinspect.page.spec.ts", "TypeScript", 0, 19, 0, 0, 6, 25
"/Users/gregd/Desktop/Gregs Workspace/Work/TravelSoft/ibus driver xristos/iBus-Driver-Application-v1/src/app/techinspect/techinspect.page.ts", "TypeScript", 0, 179, 0, 35, 32, 246
"/Users/gregd/Desktop/Gregs Workspace/Work/TravelSoft/ibus driver xristos/iBus-Driver-Application-v1/src/app/terms/terms-routing.module.ts", "TypeScript", 0, 14, 0, 0, 4, 18
"/Users/gregd/Desktop/Gregs Workspace/Work/TravelSoft/ibus driver xristos/iBus-Driver-Application-v1/src/app/terms/terms.module.ts", "TypeScript", 0, 16, 0, 0, 5, 21
"/Users/gregd/Desktop/Gregs Workspace/Work/TravelSoft/ibus driver xristos/iBus-Driver-Application-v1/src/app/terms/terms.page.html", "HTML", 7, 0, 0, 0, 3, 10
"/Users/gregd/Desktop/Gregs Workspace/Work/TravelSoft/ibus driver xristos/iBus-Driver-Application-v1/src/app/terms/terms.page.scss", "SCSS", 0, 0, 0, 0, 1, 1
"/Users/gregd/Desktop/Gregs Workspace/Work/TravelSoft/ibus driver xristos/iBus-Driver-Application-v1/src/app/terms/terms.page.spec.ts", "TypeScript", 0, 19, 0, 0, 6, 25
"/Users/gregd/Desktop/Gregs Workspace/Work/TravelSoft/ibus driver xristos/iBus-Driver-Application-v1/src/app/terms/terms.page.ts", "TypeScript", 0, 11, 0, 0, 5, 16
"/Users/gregd/Desktop/Gregs Workspace/Work/TravelSoft/ibus driver xristos/iBus-Driver-Application-v1/src/app/wallet/wallet-routing.module.ts", "TypeScript", 0, 14, 0, 0, 4, 18
"/Users/gregd/Desktop/Gregs Workspace/Work/TravelSoft/ibus driver xristos/iBus-Driver-Application-v1/src/app/wallet/wallet.module.ts", "TypeScript", 0, 20, 0, 0, 5, 25
"/Users/gregd/Desktop/Gregs Workspace/Work/TravelSoft/ibus driver xristos/iBus-Driver-Application-v1/src/app/wallet/wallet.page.html", "HTML", 119, 0, 0, 1, 24, 144
"/Users/gregd/Desktop/Gregs Workspace/Work/TravelSoft/ibus driver xristos/iBus-Driver-Application-v1/src/app/wallet/wallet.page.scss", "SCSS", 0, 0, 331, 0, 16, 347
"/Users/gregd/Desktop/Gregs Workspace/Work/TravelSoft/ibus driver xristos/iBus-Driver-Application-v1/src/app/wallet/wallet.page.spec.ts", "TypeScript", 0, 19, 0, 0, 6, 25
"/Users/gregd/Desktop/Gregs Workspace/Work/TravelSoft/ibus driver xristos/iBus-Driver-Application-v1/src/app/wallet/wallet.page.ts", "TypeScript", 0, 217, 0, 2, 30, 249
"/Users/gregd/Desktop/Gregs Workspace/Work/TravelSoft/ibus driver xristos/iBus-Driver-Application-v1/src/app/welcome/welcome-routing.module.ts", "TypeScript", 0, 14, 0, 0, 4, 18
"/Users/gregd/Desktop/Gregs Workspace/Work/TravelSoft/ibus driver xristos/iBus-Driver-Application-v1/src/app/welcome/welcome.module.ts", "TypeScript", 0, 16, 0, 0, 5, 21
"/Users/gregd/Desktop/Gregs Workspace/Work/TravelSoft/ibus driver xristos/iBus-Driver-Application-v1/src/app/welcome/welcome.page.html", "HTML", 4, 0, 0, 0, 1, 5
"/Users/gregd/Desktop/Gregs Workspace/Work/TravelSoft/ibus driver xristos/iBus-Driver-Application-v1/src/app/welcome/welcome.page.scss", "SCSS", 0, 0, 11, 0, 0, 11
"/Users/gregd/Desktop/Gregs Workspace/Work/TravelSoft/ibus driver xristos/iBus-Driver-Application-v1/src/app/welcome/welcome.page.spec.ts", "TypeScript", 0, 19, 0, 0, 6, 25
"/Users/gregd/Desktop/Gregs Workspace/Work/TravelSoft/ibus driver xristos/iBus-Driver-Application-v1/src/app/welcome/welcome.page.ts", "TypeScript", 0, 11, 0, 0, 5, 16
"/Users/gregd/Desktop/Gregs Workspace/Work/TravelSoft/ibus driver xristos/iBus-Driver-Application-v1/src/app/welcome2/welcome2-routing.module.ts", "TypeScript", 0, 14, 0, 0, 4, 18
"/Users/gregd/Desktop/Gregs Workspace/Work/TravelSoft/ibus driver xristos/iBus-Driver-Application-v1/src/app/welcome2/welcome2.module.ts", "TypeScript", 0, 16, 0, 0, 5, 21
"/Users/gregd/Desktop/Gregs Workspace/Work/TravelSoft/ibus driver xristos/iBus-Driver-Application-v1/src/app/welcome2/welcome2.page.html", "HTML", 7, 0, 0, 0, 3, 10
"/Users/gregd/Desktop/Gregs Workspace/Work/TravelSoft/ibus driver xristos/iBus-Driver-Application-v1/src/app/welcome2/welcome2.page.scss", "SCSS", 0, 0, 0, 0, 1, 1
"/Users/gregd/Desktop/Gregs Workspace/Work/TravelSoft/ibus driver xristos/iBus-Driver-Application-v1/src/app/welcome2/welcome2.page.spec.ts", "TypeScript", 0, 19, 0, 0, 6, 25
"/Users/gregd/Desktop/Gregs Workspace/Work/TravelSoft/ibus driver xristos/iBus-Driver-Application-v1/src/app/welcome2/welcome2.page.ts", "TypeScript", 0, 11, 0, 0, 5, 16
"Total", "-", 1483, 4899, 4405, 935, 1615, 13337